"filename", "language", "Batch", "TOML", "Rust", "comment", "blank", "total"
"c:\Jed\Game Projects\hypothermia\Cargo.toml", "TOML", 0, 9, 0, 1, 2, 12
"c:\Jed\Game Projects\hypothermia\build.rs", "Rust", 0, 0, 5, 0, 1, 6
"c:\Jed\Game Projects\hypothermia\pack-resources.bat", "Batch", 7, 0, 0, 0, 0, 7
"c:\Jed\Game Projects\hypothermia\src\engine.rs", "Rust", 0, 0, 4, 0, 0, 4
"c:\Jed\Game Projects\hypothermia\src\engine\core.rs", "Rust", 0, 0, 4, 0, 0, 4
"c:\Jed\Game Projects\hypothermia\src\engine\core\defaults.rs", "Rust", 0, 0, 1, 0, 1, 2
"c:\Jed\Game Projects\hypothermia\src\engine\core\defaults\components.rs", "Rust", 0, 0, 2, 0, 0, 2
"c:\Jed\Game Projects\hypothermia\src\engine\core\defaults\components\components.rs", "Rust", 0, 0, 28, 4, 5, 37
"c:\Jed\Game Projects\hypothermia\src\engine\core\defaults\components\transforms.rs", "Rust", 0, 0, 66, 4, 14, 84
"c:\Jed\Game Projects\hypothermia\src\engine\core\ecs.rs", "Rust", 0, 0, 167, 42, 20, 229
"c:\Jed\Game Projects\hypothermia\src\engine\core\window.rs", "Rust", 0, 0, 41, 5, 10, 56
"c:\Jed\Game Projects\hypothermia\src\engine\core\world.rs", "Rust", 0, 0, 169, 43, 14, 226
"c:\Jed\Game Projects\hypothermia\src\engine\input.rs", "Rust", 0, 0, 109, 27, 4, 140
"c:\Jed\Game Projects\hypothermia\src\engine\rendering.rs", "Rust", 0, 0, 227, 36, 23, 286
"c:\Jed\Game Projects\hypothermia\src\engine\resources.rs", "Rust", 0, 0, 197, 45, 16, 258
"c:\Jed\Game Projects\hypothermia\src\game.rs", "Rust", 0, 0, 2, 0, 0, 2
"c:\Jed\Game Projects\hypothermia\src\game\components.rs", "Rust", 0, 0, 0, 0, 1, 1
"c:\Jed\Game Projects\hypothermia\src\game\level.rs", "Rust", 0, 0, 101, 25, 6, 132
"c:\Jed\Game Projects\hypothermia\src\main.rs", "Rust", 0, 0, 19, 3, 4, 26
"Total", "-", 7, 9, 1142, 235, 121, 1514